[
  ["11111111111111111111111111111111111111111111111111"],
  ["11111111111111111111111111111111111111111111111111"],
  ["11000000000000000000000000000000000000000000000000"],
  ["11000000000000000000000000000000000000000000000000"],
  ["11000000000000000000000000000000000000000000000000"],
  ["11000000000000000000000000000000000000000000000000"],
  ["11000000000000000000000000000000000000000000000000"],
  ["11000000000000000000000000000000000000000000000000"],
  ["11000000000000000000000000000000000000000000000000"],
  ["11000000000000000000000000000000000000000000000000"],
  ["11000000000000000000000000000000000000000000000000"],
  ["11000000000000000000000000000000000000000000000000"],
  ["11000000000000000000000000000000000000000000000000"],
  ["11000000000000000000000000000000000000000000000000"],
  ["11100000000000000000000000000000000000000000000000"],
  ["11110000000000000000000000000000000000000000000000"],
  ["11110000000000000000000000000000000000000000000000"],
  ["11111000000000000000000000000000000000000000000000"],
  ["11110000000000000000000000000000000000000000000000"],
  ["11110000000000000000000000000000000000000000000000"],
  ["11110000000000000000000000000000000000000000000000"],
  ["11100000000000000000000000000000000000000000000000"],
  ["11000000000000000000000000000000000000000000000012"],
  ["21000000000000000000000000000000000000000000000022"],
  ["22000000000000000000000000000000000000000000022222"],
  ["22000000000000000000000000000000000000000000022222"],
  ["22200000000000000000000000000000000000002222222222"],
  ["22220000000000000000000000000002222222222222222222"],
  ["22222222222222222222222222222222222222222222222222"],
  ["22222222222222222222222222222222222222222222222222"]
]
