[
  ["11111111111111111111111111111111111111111111111111"],
  ["11111111111112111111111111111111111111111111111111"],
  ["11111100000122150000000000000003333333333333333111"],
  ["11110000000022000000000000000000000333333333333311"],
  ["11000000000002200000000000000000000000003333333111"],
  ["11000000000000220000000000000000000000000333333111"],
  ["11100000000000220000000000000000000000003333333511"],
  ["11110000000000022000000000000000000000000033333311"],
  ["11000000000000002220000000000000000000000000331111"],
  ["10000000000000000022200000000000000000000000331111"],
  ["10000000000000000000222200000000000000000003311111"],
  ["11000000000000000000000220000000000000000333311111"],
  ["11000000000000000000000022200000000000000333333111"],
  ["11000000000000000000000002220000000000033333333311"],
  ["11100000000000000000000000022000000000003333333311"],
  ["11110000000000000000000000220000000000000333333301"],
  ["11110000000000000000000000220000000000000033333331"],
  ["11111000000000000000000000220000000000000003333311"],
  ["11110000000000000000000002200000000000000000003311"],
  ["11110000000000000000000022000000000000000000033111"],
  ["11110000000000000000000220000000000000000000111111"],
  ["11100000000000000000000220000000000000000044441111"],
  ["11000000000000000000002233333333330000044444444412"],
  ["21000000000000000000022333333333000004444444444422"],
  ["22000000000000000000022333333330000444444444422222"],
  ["22000000000000000000223333333330044444444444422222"],
  ["22200000000000000002233333333114444444442222222222"],
  ["22220000000000000002233333511112222222222222222222"],
  ["22222222222222222222222222222222222222222222222222"],
  ["22222222222222222222222222222222222222222222222222"]
]
