[
    ["99991111111111111111111111111111111111111111119999"],
    ["99111111111112111111111111111111111111111111111199"],
    ["91111100000122100000000000000003333333333333333119"],
    ["91110000000022000000000000000000000333333333333319"],
    ["11000000000002200000000000000000000000003333333111"],
    ["11000000000000220000000000000000000000000333333111"],
    ["11100000000000220000000000000000000000003333333311"],
    ["11110000000000022000000000000000000000000033333311"],
    ["11000000000000002220000000000000000000000000331111"],
    ["10000000000000000022200000000000000000000000331111"],
    ["10000000000000000000222200000000000000000003311111"],
    ["11300000000000000000000220000000000000000333311111"],
    ["11330000333330003300333022200000000000000333333111"],
    ["11333333333333333333333332223000000000033333333311"],
    ["11133333333333333333333333322330000000003333333311"],
    ["11113333333333333333333333223333300000000333333331"],
    ["11113333333333333333333333223333333000000033333331"],
    ["11111333333333333333333333223333333300000003333311"],
    ["11113333333333333333333332233333333300000000003311"],
    ["11113333333333333333333322333333333000000000033111"],
    ["11113333333333333333333223333333333000000000111111"],
    ["11133333333333333333333223333333330000000055551111"],
    ["11333333333333333333332233333333330000055555555512"],
    ["21333333333333333333322333333333000005555555555522"],
    ["22300333000300000333022333333330000555555555522222"],
    ["22550000050005550000223333333330055555555555522222"],
    ["22255555555555555552233333333115555555552222222229"],
    ["92225555555555555552233333311112222222222222222299"],
    ["99222222222222222222222222222222222222222222229999"],
    ["99992222222222222222222222222222222222222222999999"]
]